Player,Overall_K,Overall_D,Overall_KD,Overall_+/-,Overall_M,SnD_K,SnD_D,SnD_KD,SnD_+/-,SnD_K/M,SnD_FK,SnD_M,Hardpoint_K,Hardpoint_D,Hardpoint_KD,Hardpoint_+/-,Hardpoint_K/M,Hardpoint_TM,Hardpoint_M,Control_K,Control_D,Control_KD,Control_+/-,Control_K/M,Control_CP,Control_M
JoeDeceives,507,454,1.117,53,24,49,45,1.089,4,7.0,7,7,315,270,1.167,45,28.6,912,11,143,139,1.029,4,23.8,35,6
CleanX,483,490,0.986,-7,24,43,53,0.811,-10,6.1,9,7,300,291,1.031,9,27.3,477,11,140,146,0.959,-6,23.3,14,6
Mercules,474,440,1.077,34,24,46,45,1.022,1,6.6,6,7,274,260,1.054,14,24.9,912,11,154,135,1.141,19,25.7,22,6
Insight,426,418,1.019,8,24,36,47,0.766,-11,5.1,7,7,275,248,1.109,27,25.0,584,11,115,123,0.935,-8,19.2,31,6
Neptune,411,408,1.007,3,21,42,40,1.050,2,7.0,6,6,282,260,1.085,22,28.2,683,10,87,108,0.806,-21,17.4,5,5
Nastie,382,353,1.082,29,21,36,37,0.973,-1,6.0,3,6,257,213,1.207,44,25.7,653,10,89,103,0.864,-14,17.8,16,5
Abuzah,381,370,1.030,11,21,43,31,1.387,12,7.2,7,6,252,242,1.041,10,25.2,757,10,86,97,0.887,-11,17.2,13,5
04,366,412,0.888,-46,21,40,45,0.889,-5,6.7,14,6,244,261,0.935,-17,24.4,553,10,82,106,0.774,-24,16.4,16,5
MettalZ,318,321,0.991,-3,17,36,41,0.878,-5,6.0,8,6,196,196,1.000,0,28.0,388,7,86,84,1.024,2,21.5,15,4
HyDra,311,245,1.269,66,15,38,29,1.310,9,7.6,6,5,192,148,1.297,44,32.0,307,6,81,68,1.191,13,20.3,2,4
Scrap,299,245,1.220,54,15,41,23,1.783,18,8.2,7,5,169,154,1.097,15,28.2,392,6,89,68,1.309,21,22.3,15,4
RenKoR,296,293,1.010,3,17,33,38,0.868,-5,5.5,3,6,180,173,1.041,7,25.7,348,7,83,82,1.012,1,20.8,11,4
ReeaL,292,299,0.977,-7,17,39,36,1.083,3,6.5,8,6,177,180,0.983,-3,25.3,471,7,76,83,0.916,-7,19.0,7,4
SupeR,280,272,1.029,8,17,29,37,0.784,-8,4.8,7,6,178,164,1.085,14,25.4,425,7,73,71,1.028,2,18.3,16,4
Simp,276,255,1.082,21,15,49,34,1.441,15,9.8,4,5,135,142,0.951,-7,22.5,335,6,92,79,1.165,13,23.0,29,4
Envoy,272,261,1.042,11,15,38,30,1.267,8,7.6,7,5,137,161,0.851,-24,22.8,519,6,97,70,1.386,27,24.3,12,4
aBeZy,258,256,1.008,2,15,31,33,0.939,-2,6.2,9,5,137,145,0.945,-8,22.8,427,6,90,78,1.154,12,22.5,24,4
Cellium,256,228,1.123,28,15,36,35,1.029,1,7.2,5,5,140,125,1.120,15,23.3,392,6,80,68,1.177,12,20.0,13,4
Drazah,242,258,0.938,-16,15,39,34,1.147,5,7.8,7,5,120,141,0.851,-21,20.0,307,6,83,83,1.000,0,20.8,12,4
Ghosty,239,244,0.980,-5,15,22,27,0.815,-5,4.4,6,5,141,148,0.953,-7,23.5,624,6,76,69,1.101,7,19.0,15,4
Purj,218,220,0.991,-2,11,19,20,0.950,-1,6.3,3,3,116,138,0.841,-22,23.2,184,5,83,62,1.339,21,27.7,16,3
Shotzzy,201,183,1.098,18,9,25,21,1.191,4,8.3,6,3,95,88,1.080,7,31.7,182,3,81,74,1.095,7,27.0,12,3
Owakening,197,212,0.929,-15,11,15,16,0.938,-1,5.0,2,3,119,135,0.882,-16,23.8,139,5,63,61,1.033,2,21.0,18,3
Snoopy,195,218,0.895,-23,11,18,17,1.059,1,6.0,1,3,105,134,0.784,-29,21.0,134,5,72,67,1.075,5,24.0,13,3
Dashy,190,177,1.073,13,9,11,20,0.550,-9,3.7,3,3,87,90,0.967,-3,29.0,136,3,92,67,1.373,25,30.7,8,3
Huke,182,177,1.028,5,9,22,18,1.222,4,7.3,2,3,89,83,1.072,6,29.7,185,3,71,76,0.934,-5,23.7,13,3
Cammy,181,221,0.819,-40,11,18,15,1.200,3,6.0,4,3,105,141,0.745,-36,21.0,286,5,58,65,0.892,-7,19.3,16,3
Nero,166,155,1.071,11,8,13,10,1.300,3,6.5,1,2,109,93,1.172,16,27.3,281,4,44,52,0.846,-8,22.0,8,2
Gio,163,155,1.052,8,8,9,11,0.818,-2,4.5,1,2,110,98,1.122,12,27.5,134,4,44,46,0.957,-2,22.0,4,2
Kenny,158,165,0.958,-7,8,17,12,1.417,5,8.5,3,2,104,105,0.991,-1,26.0,299,4,37,48,0.771,-11,18.5,5,2
Estreal,156,159,0.981,-3,8,15,10,1.500,5,7.5,4,2,100,100,1.000,0,25.0,228,4,41,49,0.837,-8,20.5,8,2
Skyz,146,177,0.825,-31,9,14,18,0.778,-4,4.7,2,3,64,79,0.810,-15,21.3,224,3,68,80,0.850,-12,22.7,11,3
Gwinn,136,136,1.000,0,7,12,15,0.800,-3,6.0,3,2,80,82,0.976,-2,26.7,194,3,44,39,1.128,5,22.0,12,2
TJHaLy,121,146,0.829,-25,7,12,14,0.857,-2,6.0,2,2,65,86,0.756,-21,21.7,167,3,44,46,0.957,-2,22.0,5,2
SlasheR,111,121,0.917,-10,7,7,13,0.539,-6,3.5,0,2,61,73,0.836,-12,20.3,133,3,43,35,1.229,8,21.5,10,2
Wrecks,110,143,0.769,-33,7,7,14,0.500,-7,3.5,1,2,69,85,0.812,-16,23.0,144,3,34,44,0.773,-10,17.0,4,2
Exnid,62,61,1.016,1,3,8,6,1.333,2,8.0,1,1,26,33,0.788,-7,26.0,17,1,28,22,1.273,6,28.0,0,1
Arcitys,49,57,0.860,-8,3,4,7,0.571,-3,4.0,1,1,29,27,1.074,2,29.0,39,1,16,23,0.696,-7,16.0,3,1
Pred,48,59,0.814,-11,3,5,7,0.714,-2,5.0,1,1,30,29,1.035,1,30.0,49,1,13,23,0.565,-10,13.0,1,1
Sib,46,47,0.979,-1,3,12,7,1.714,5,12.0,1,1,26,22,1.182,4,26.0,22,1,8,18,0.444,-10,8.0,1,1
Lunarz,45,50,0.900,-5,3,6,7,0.857,-1,6.0,1,1,16,19,0.842,-3,16.0,39,1,23,24,0.958,-1,23.0,7,1
oJohnny,42,60,0.700,-18,3,7,7,1.000,0,7.0,2,1,10,25,0.400,-15,10.0,7,1,25,28,0.893,-3,25.0,5,1
Mack,42,46,0.913,-4,3,7,9,0.778,-2,7.0,2,1,19,23,0.826,-4,19.0,92,1,16,14,1.143,2,16.0,1,1
FeLo,42,50,0.840,-8,3,5,8,0.625,-3,5.0,2,1,16,17,0.941,-1,16.0,7,1,21,25,0.840,-4,21.0,4,1
KiSMET,40,63,0.635,-23,3,5,7,0.714,-2,5.0,1,1,13,30,0.433,-17,13.0,17,1,22,26,0.846,-4,22.0,4,1
Priestahh,38,60,0.633,-22,3,2,7,0.286,-5,2.0,0,1,20,31,0.645,-11,20.0,80,1,16,22,0.727,-6,16.0,0,1
Kremp,33,45,0.733,-12,3,8,7,1.143,1,8.0,2,1,17,21,0.810,-4,17.0,30,1,8,17,0.471,-9,8.0,0,1
Attach,30,42,0.714,-12,3,1,9,0.111,-8,1.0,0,1,21,21,1.000,0,21.0,38,1,8,12,0.667,-4,8.0,0,1
