Rank,Player,Overall_K,Overall_D,Overall_KD,Overall_+/-,Overall_M,SND_K,SND_D,SND_KD,SND_+/-,SND_K/M,SND_FK,SND_M,HP_K,HP_D,HP_KD,HP_+/-,HP_K/M,HP_TM,HP_M,Control_K,Control_D,Control_KD,Control_+/-,Control_K/M,Control_CP,Control_M
1,HyDra,506,457,1.107,49,25,60,43,1.395,17,7.5,13,8,283,259,1.093,24,28.3,431,10,163,155,1.052,8,23.3,13,7
2,Scrap,486,445,1.092,41,25,50,41,1.220,9,6.3,11,8,287,268,1.071,19,28.7,575,10,149,136,1.096,13,21.3,40,7
3,Envoy,472,471,1.002,1,25,65,39,1.667,26,8.1,7,8,251,282,0.890,-31,25.1,662,10,156,150,1.040,6,22.3,31,7
4,Ghosty,434,435,0.998,-1,25,40,42,0.952,-2,5.0,7,8,247,253,0.976,-6,24.7,1024,10,147,140,1.050,7,21.0,39,7
5,Simp,389,322,1.208,67,18,35,33,1.061,2,7.0,6,5,245,187,1.310,58,30.6,771,8,109,102,1.069,7,21.8,21,5
6,JoeDeceives,371,325,1.142,46,17,27,33,0.818,-6,5.4,6,5,224,196,1.143,28,28.0,706,8,120,96,1.250,24,30.0,27,4
7,Nero,370,326,1.135,44,17,36,38,0.947,-2,6.0,12,6,246,195,1.262,51,35.1,480,7,88,93,0.946,-5,22.0,21,4
8,CleanX,363,367,0.989,-4,17,28,34,0.824,-6,5.6,6,5,221,224,0.987,-3,27.6,345,8,114,109,1.046,5,28.5,13,4
9,aBeZy,349,350,0.997,-1,18,29,43,0.674,-14,5.8,5,5,215,204,1.054,11,26.9,563,8,105,103,1.019,2,21.0,13,5
10,Cellium,345,310,1.113,35,18,31,38,0.816,-7,6.2,3,5,211,175,1.206,36,26.4,354,8,103,97,1.062,6,20.6,10,5
11,Drazah,343,347,0.989,-4,18,30,38,0.790,-8,6.0,5,5,215,200,1.075,15,26.9,571,8,98,109,0.899,-11,19.6,11,5
12,Beans,325,338,0.962,-13,17,32,33,0.970,-1,6.4,2,5,195,215,0.907,-20,24.4,482,8,98,90,1.089,8,24.5,29,4
13,Mercules,322,317,1.016,5,16,33,29,1.138,4,8.3,8,4,222,217,1.023,5,27.8,623,8,67,71,0.944,-4,16.8,15,4
14,Shotzzy,320,325,0.985,-5,16,28,27,1.037,1,7.0,6,4,228,221,1.032,7,28.5,421,8,64,77,0.831,-13,16.0,7,4
15,Kenny,315,309,1.019,6,17,40,35,1.143,5,6.7,9,6,184,183,1.006,1,26.3,336,7,91,91,1.000,0,22.8,11,4
16,Huke,311,308,1.010,3,16,25,27,0.926,-2,6.3,5,4,221,207,1.068,14,27.6,418,8,65,74,0.878,-9,16.3,14,4
17,RenKoR,310,279,1.111,31,15,39,26,1.500,13,7.8,3,5,196,163,1.203,33,32.7,344,6,75,90,0.833,-15,18.8,6,4
18,Gio,296,288,1.028,8,17,27,35,0.771,-8,4.5,3,6,178,173,1.029,5,25.4,464,7,91,80,1.138,11,22.8,17,4
19,ReeaL,296,279,1.061,17,15,29,32,0.906,-3,5.8,4,5,178,165,1.079,13,29.7,331,6,89,82,1.085,7,22.3,11,4
20,Insight,292,331,0.882,-39,17,18,32,0.563,-14,3.6,4,5,193,208,0.928,-15,24.1,369,8,81,91,0.890,-10,20.3,14,4
21,Dashy,288,304,0.947,-16,16,25,25,1.000,0,6.3,3,4,180,208,0.865,-28,22.5,607,8,83,71,1.169,12,20.8,6,4
22,Estreal,283,303,0.934,-20,17,40,33,1.212,7,6.7,5,6,162,185,0.876,-23,23.1,384,7,81,85,0.953,-4,20.3,16,4
23,MettalZ,257,295,0.871,-38,15,25,32,0.781,-7,5.0,8,5,152,170,0.894,-18,25.3,439,6,80,93,0.860,-13,20.0,5,4
24,SupeR,243,254,0.957,-11,15,33,29,1.138,4,6.6,9,5,136,146,0.932,-10,22.7,573,6,74,79,0.937,-5,18.5,14,4
25,Pred,193,157,1.229,36,10,32,20,1.600,12,8.0,6,4,116,107,1.084,9,29.0,156,4,45,30,1.500,15,22.5,7,2
26,Exnid,186,176,1.057,10,10,29,24,1.208,5,7.3,7,4,111,113,0.982,-2,27.8,191,4,46,39,1.180,7,23.0,6,2
27,oJohnny,164,145,1.131,19,7,16,12,1.333,4,8.0,6,2,81,84,0.964,-3,27.0,133,3,67,49,1.367,18,33.5,4,2
28,Arcitys,163,167,0.976,-4,10,21,26,0.808,-5,5.3,4,4,96,102,0.941,-6,24.0,247,4,46,39,1.180,7,23.0,7,2
29,KiSMET,147,158,0.930,-11,7,9,13,0.692,-4,4.5,2,2,82,81,1.012,1,27.3,138,3,56,64,0.875,-8,28.0,10,2
30,Lunarz,140,129,1.085,11,7,22,8,2.750,14,11.0,1,2,72,71,1.014,1,24.0,153,3,46,50,0.920,-4,23.0,9,2
31,FeLo,137,138,0.993,-1,7,11,10,1.100,1,5.5,3,2,71,75,0.947,-4,23.7,160,3,55,53,1.038,2,27.5,6,2
32,Priestahh,135,175,0.771,-40,10,21,22,0.955,-1,5.3,2,4,70,113,0.620,-43,17.5,199,4,44,40,1.100,4,22.0,11,2
33,Kremp,132,149,0.886,-17,7,11,13,0.846,-2,5.5,3,2,61,77,0.792,-16,20.3,151,3,60,59,1.017,1,30.0,5,2
34,Spart,128,141,0.908,-13,7,14,12,1.167,2,7.0,1,2,61,75,0.813,-14,20.3,183,3,53,54,0.982,-1,26.5,2,2
35,Capsidal,126,159,0.793,-33,7,13,13,1.000,0,6.5,2,2,65,90,0.722,-25,21.7,75,3,48,56,0.857,-8,24.0,10,2
36,Sib,124,158,0.785,-34,7,14,15,0.933,-1,7.0,4,2,66,80,0.825,-14,22.0,167,3,44,63,0.698,-19,22.0,9,2
37,Neptune,117,139,0.842,-22,8,20,24,0.833,-4,6.7,5,3,68,78,0.872,-10,22.7,104,3,29,37,0.784,-8,14.5,0,2
38,Abuzah,115,135,0.852,-20,8,9,22,0.409,-13,3.0,1,3,78,78,1.000,0,26.0,180,3,28,35,0.800,-7,14.0,3,2
39,Nastie,112,130,0.862,-18,8,13,21,0.619,-8,4.3,1,3,79,74,1.068,5,26.3,150,3,20,35,0.571,-15,10.0,2,2
40,04,103,144,0.715,-41,8,19,21,0.905,-2,6.3,3,3,66,83,0.795,-17,22.0,205,3,18,40,0.450,-22,9.0,4,2
41,Cammy,97,104,0.933,-7,5,11,15,0.733,-4,5.5,0,2,58,61,0.951,-3,29.0,55,2,28,28,1.000,0,28.0,4,1
42,Snoopy,96,94,1.021,2,5,12,16,0.750,-4,6.0,4,2,53,49,1.082,4,26.5,171,2,31,29,1.069,2,31.0,2,1
43,Purj,95,109,0.872,-14,5,8,16,0.500,-8,4.0,2,2,60,64,0.938,-4,30.0,111,2,27,29,0.931,-2,27.0,6,1
44,SlasheR,94,82,1.146,12,5,11,9,1.222,2,5.5,2,2,53,47,1.128,6,26.5,47,2,30,26,1.154,4,30.0,1,1
45,Owakening,92,100,0.920,-8,5,12,16,0.750,-4,6.0,0,2,55,59,0.932,-4,27.5,192,2,25,25,1.000,0,25.0,2,1
46,TJHaLy,90,103,0.874,-13,5,15,11,1.364,4,7.5,5,2,47,59,0.797,-12,23.5,94,2,28,33,0.849,-5,28.0,1,1
47,Gwinn,89,87,1.023,2,5,12,10,1.200,2,6.0,2,2,42,50,0.840,-8,21.0,155,2,35,27,1.296,8,35.0,5,1
48,Wrecks,75,83,0.904,-8,5,9,9,1.000,0,4.5,2,2,39,49,0.796,-10,19.5,68,2,27,25,1.080,2,27.0,6,1